F--|--7-
|F-|-7|-
||F|F---
---sJ||-
||L|-J|-
|L-|--J-
L--|---g