F--|--7-
|F-|-7|-
||F|F---
---gJ||-
||L|-J|-
|L-|--J-
L--|---s